NO                          ./assets/leosantana.xpm
NO ./assets/german.xpm

F              37,168,44
SO               ./assets/tin.xpm
WE ./assets/lula.xpm











        1111111111111111111111111
        1000000000110000000000001
        1011000001110000000000001
        1001000000000000000000001           
111111111011000001110000000000001
100000000011000001110111111111111
11110111111111011100000010001
11111111111111011101010010001
11000001110101011100000010001          
10000001000000001100000010001
1000E00100000000110101000000111            
1100000111010101111101100011001
11110111 1110101 10111101011111
11111111 1111111 1111111111




                
                   

