NO ./assets/42_NO.xpm
SO ./assets/42_SO.xpm
WE ./assets/42_WE.xpm
EA ./assets/42_EA.xpm

F 220,100,0
C 225,30,0

1111111111111011111111111111111111111111
1000000000000000000000000000000000000001
1111111111111111100000000011111110111111
                10000000001
  111111111111111000000000111111111111
  100000000000000000000000000000000001
  111111111111111000000000111111111111
                10000000001
1111111111111111100000000011111111111111
100000000000000000000N000000000000000001
1111111111111111111111111111111111111111