NO ./assets/42_NO.xpm
SO ./assets/42_SO.xpm
WE ./assets/42_WE.xpm
EA ./assets/42_EA.xpm

F 220,100,0
C 225,30,0

111111111111111111
100000001000000001
110000000000000001
110000000000000011
11000000N000000011
110000000000000001
100000011100000001
111111111111111111

